48 48 30 45
018 018 018 018 018 018 018 018 018 018 018 018 018 018 018 021 021 021 021 021 021 021 021 021 021 021 021 021 021 021
018 018 018 018 018 018 018 018 018 018 018 018 018 018 018 021 021 021 021 021 021 021 021 021 021 021 021 021 021 021 
018 018 018 018 018 018 018 018 018 018 018 018 018 018 018 021 021 021 021 021 021 021 021 021 021 021 021 021 021 021 
018 018 018 018 018 018 018 018 018 018 018 018 018 018 018 021 021 021 021 021 021 021 021 021 021 021 021 021 021 021 
018 018 018 018 018 018 018 018 018 018 018 018 018 018 018 021 021 021 021 021 021 021 021 021 021 021 021 021 021 021 
018 018 018 018 018 018 018 018 018 018 018 018 018 018 018 021 021 021 021 021 021 021 021 021 021 021 021 021 021 021 
018 018 018 018 018 018 018 018 018 018 018 018 018 018 018 021 021 021 021 021 021 021 021 021 021 021 021 021 021 021 
018 018 018 018 018 018 018 018 018 018 018 018 018 018 018 021 021 021 021 021 021 021 021 021 021 021 021 021 021 021 
018 018 018 018 018 018 018 018 018 018 018 018 018 018 018 021 021 021 021 021 021 021 021 021 021 021 021 021 021 021 
018 018 018 018 018 018 018 018 018 018 018 018 018 018 018 021 021 021 021 021 021 021 021 021 021 021 021 021 021 021
018 018 018 018 018 018 018 018 018 018 018 018 018 018 018 021 021 021 021 021 021 021 021 021 021 021 021 021 021 021
018 018 018 018 018 018 018 018 018 018 018 018 018 018 006 000 008 021 021 021 021 021 021 021 021 021 021 021 021 021
018 018 018 018 018 018 018 018 018 018 018 018 018 006 000 000 000 008 021 021 021 021 021 021 021 021 021 021 021 021
018 018 018 018 018 018 018 018 018 018 018 018 018 000 000 000 000 000 008 021 021 021 021 021 021 021 021 021 021 021
018 018 018 018 018 018 018 018 018 018 018 018 006 000 000 000 000 000 000 008 021 021 021 021 021 021 021 021 021 021
018 018 018 018 018 018 018 018 018 018 018 006 000 000 000 000 000 000 000 000 008 021 021 021 021 021 021 021 021 021
018 018 018 018 018 018 018 018 018 018 006 000 000 000 000 000 000 000 000 000 000 021 021 021 021 021 021 021 021 021
018 018 018 018 018 018 018 018 018 018 000 000 000 000 000 000 000 000 000 000 000 008 021 021 021 021 021 021 021 021
018 018 018 018 018 018 018 018 018 018 000 000 000 000 000 000 000 000 000 000 000 000 021 021 021 021 021 021 021 021
018 018 018 018 018 018 018 018 018 018 000 000 000 000 000 000 000 000 000 000 000 000 021 021 021 021 021 021 021 021
018 018 018 018 018 018 018 018 018 014 009 000 000 000 000 000 000 000 000 000 000 000 021 021 021 021 021 021 021 021
021 021 021 021 021 021 021 021 021 021 021 009 000 000 000 000 000 000 000 000 000 007 021 021 021 021 021 021 021 021
021 021 021 021 021 021 021 021 021 021 021 021 021 009 000 000 000 000 007 021 021 021 021 021 021 021 021 021 021 021
021 021 021 021 021 021 021 021 021 021 021 021 021 021 021 021 021 021 021 021 021 021 021 021 021 021 021 021 021 021
021 021 021 021 021 021 021 021 021 021 021 021 021 021 021 021 021 021 021 021 021 021 021 021 021 021 021 021 021 021
021 021 021 021 021 021 021 021 021 021 021 021 021 021 021 021 021 021 021 021 021 021 021 021 021 021 021 021 021 021
021 021 021 021 021 021 021 021 021 021 021 021 021 021 021 021 021 021 021 021 021 021 021 021 021 021 021 021 021 021
021 021 021 021 021 021 021 021 021 021 021 021 021 021 021 021 021 021 021 021 021 021 021 021 021 021 021 021 021 021
021 021 021 021 021 021 021 021 021 021 021 021 021 021 021 021 021 021 021 021 021 021 021 021 021 021 021 021 021 021
021 021 021 021 021 021 021 021 021 021 021 021 021 021 021 021 021 021 021 021 021 021 021 021 021 021 021 021 021 021
021 021 021 021 021 021 021 021 021 021 021 021 021 021 021 021 021 021 021 021 021 021 021 021 021 021 021 021 021 021
021 021 021 021 021 021 021 021 021 021 021 021 021 021 021 021 021 021 021 021 021 021 021 021 021 021 021 021 021 021
021 021 021 021 021 021 021 021 021 021 021 021 021 021 021 021 021 021 021 021 021 021 021 021 021 021 021 021 021 021
021 021 021 021 021 021 021 021 021 021 021 021 021 021 021 021 021 021 021 021 021 021 021 021 021 021 021 021 021 021 
021 021 021 021 021 021 021 021 021 021 021 021 021 021 021 021 021 021 021 021 021 021 021 021 021 021 021 021 021 017 
021 021 021 021 021 021 021 021 021 021 021 021 021 021 021 021 021 021 021 021 021 021 021 017 011 011 011 011 011 011
021 021 021 021 021 021 021 021 021 021 021 021 021 021 021 021 017 011 011 011 011 011 011 011 011 011 011 011 011 011 
015 021 021 021 021 021 021 021 021 021 021 017 011 011 011 011 011 011 011 011 011 011 011 011 011 011 011 011 011 011 
011 011 011 011 011 011 011 011 011 011 011 011 011 011 011 011 011 011 011 011 011 011 011 011 011 011 011 011 011 011 
011 011 011 011 011 011 011 011 011 011 011 011 011 011 011 011 011 011 011 011 011 011 011 011 011 011 011 011 011 027 
011 011 011 011 011 011 011 011 011 011 011 011 011 011 011 011 011 011 011 011 011 011 011 011 011 027 024 024 024 024 
011 011 011 011 011 011 011 011 011 011 011 011 011 011 011 011 011 011 011 011 011 011 011 027 024 024 024 024 024 024 
011 011 011 011 011 011 011 011 011 011 011 011 011 011 011 011 011 011 011 011 011 011 011 024 024 024 024 024 024 024
011 011 011 011 011 011 011 011 011 011 011 011 011 011 011 011 011 011 011 011 011 011 011 024 024 024 024 024 024 024 
011 011 011 011 011 011 011 011 011 011 011 011 011 011 011 011 011 011 011 011 011 011 027 024 024 024 024 024 024 024
